"filename", "language", "Makefile", "C++", "comment", "blank", "total"
"/home/ubuntu/FDDDM/FDDDM_Base/Sod/ComputeDt.cpp", "C++", 0, 37, 0, 3, 40
"/home/ubuntu/FDDDM/FDDDM_Base/Sod/Conserve2Flux.cpp", "C++", 0, 32, 0, 2, 34
"/home/ubuntu/FDDDM/FDDDM_Base/Sod/Initialize.cpp", "C++", 0, 44, 0, 0, 44
"/home/ubuntu/FDDDM/FDDDM_Base/Sod/Lax_Scheme.cpp", "C++", 0, 52, 0, 4, 56
"/home/ubuntu/FDDDM/FDDDM_Base/Sod/MUSCL_Scheme.cpp", "C++", 0, 89, 0, 8, 97
"/home/ubuntu/FDDDM/FDDDM_Base/Sod/Makefile", "Makefile", 11, 0, 0, 3, 14
"/home/ubuntu/FDDDM/FDDDM_Base/Sod/Psy_coord.cpp", "C++", 0, 23, 0, 2, 25
"/home/ubuntu/FDDDM/FDDDM_Base/Sod/RegularBound.cpp", "C++", 0, 59, 3, 11, 73
"/home/ubuntu/FDDDM/FDDDM_Base/Sod/Riemann_solver.cpp", "C++", 0, 117, 0, 12, 129
"/home/ubuntu/FDDDM/FDDDM_Base/Sod/Slope_limiter.cpp", "C++", 0, 15, 0, 0, 15
"/home/ubuntu/FDDDM/FDDDM_Base/Sod/Sod.cpp", "C++", 0, 81, 5, 15, 101
"/home/ubuntu/FDDDM/FDDDM_Base/Sod/WriteData.cpp", "C++", 0, 39, 0, 1, 40
"Total", "-", 11, 588, 8, 61, 668