"filename", "language", "Makefile", "C++", "Markdown", "comment", "blank", "total"
"/home/ubuntu/FDDDM/FDDDM_Base/Sod/ComputeDt.cpp", "C++", 0, -37, 0, 0, -3, -40
"/home/ubuntu/FDDDM/FDDDM_Base/Sod/Conserve2Flux.cpp", "C++", 0, -32, 0, 0, -2, -34
"/home/ubuntu/FDDDM/FDDDM_Base/Sod/Initialize.cpp", "C++", 0, -44, 0, 0, 0, -44
"/home/ubuntu/FDDDM/FDDDM_Base/Sod/Lax_Scheme.cpp", "C++", 0, -52, 0, 0, -4, -56
"/home/ubuntu/FDDDM/FDDDM_Base/Sod/MUSCL_Scheme.cpp", "C++", 0, -118, 0, 0, -8, -126
"/home/ubuntu/FDDDM/FDDDM_Base/Sod/Makefile", "Makefile", -11, 0, 0, 0, -3, -14
"/home/ubuntu/FDDDM/FDDDM_Base/Sod/Psy_coord.cpp", "C++", 0, -23, 0, 0, -2, -25
"/home/ubuntu/FDDDM/FDDDM_Base/Sod/RegularBound.cpp", "C++", 0, -59, 0, -3, -11, -73
"/home/ubuntu/FDDDM/FDDDM_Base/Sod/Riemann_solver.cpp", "C++", 0, -117, 0, 0, -12, -129
"/home/ubuntu/FDDDM/FDDDM_Base/Sod/Slope_limiter.cpp", "C++", 0, -15, 0, 0, 0, -15
"/home/ubuntu/FDDDM/FDDDM_Base/Sod/Sod.cpp", "C++", 0, -81, 0, -5, -15, -101
"/home/ubuntu/FDDDM/FDDDM_Base/Sod/WriteData.cpp", "C++", 0, -39, 0, 0, -1, -40
"/home/ubuntu/FDDDM/Test/Sod/Makefile", "Makefile", 12, 0, 0, 0, 4, 16
"/home/ubuntu/FDDDM/Test/Sod/SimpleParamReader-master/ParamReader.cpp", "C++", 0, 67, 0, 8, 10, 85
"/home/ubuntu/FDDDM/Test/Sod/SimpleParamReader-master/ParamReader.h", "C++", 0, 46, 0, 7, 8, 61
"/home/ubuntu/FDDDM/Test/Sod/SimpleParamReader-master/README.md", "Markdown", 0, 0, 5, 0, 3, 8
"/home/ubuntu/FDDDM/Test/Sod/SimpleParamReader-master/test_main.cpp", "C++", 0, 14, 0, 0, 2, 16
"/home/ubuntu/FDDDM/Test/Sod/Sod.cpp", "C++", 0, 88, 0, 2, 17, 107
"Total", "-", 1, -402, 5, 9, -17, -404