"filename", "language", "Markdown", "C++", "Makefile", "JSON", "comment", "blank", "total"
"/home/ubuntu/IB2TF/README.md", "Markdown", 2, 0, 0, 0, 0, 1, 3
"/home/ubuntu/IB2TF/Src/Base/Advance/Lax/Lax_Scheme.cpp", "C++", 0, 68, 0, 0, 9, 6, 83
"/home/ubuntu/IB2TF/Src/Base/Advance/MUSCL/MUSCL_Scheme.cpp", "C++", 0, 112, 0, 0, 0, 7, 119
"/home/ubuntu/IB2TF/Src/Base/Common/ComputeDt.cpp", "C++", 0, 37, 0, 0, 0, 3, 40
"/home/ubuntu/IB2TF/Src/Base/Common/Conserve2Flux.cpp", "C++", 0, 32, 0, 0, 0, 4, 36
"/home/ubuntu/IB2TF/Src/Base/Riemann/HLL/Riemann_solver.cpp", "C++", 0, 99, 0, 0, 0, 7, 106
"/home/ubuntu/IB2TF/Src/Base/Riemann/PVRS/Riemann_solver.cpp", "C++", 0, 279, 0, 0, 0, 10, 289
"/home/ubuntu/IB2TF/Src/Base/Slope_limiter/VanAlbada/Slope_limiter.cpp", "C++", 0, 18, 0, 0, 0, 2, 20
"/home/ubuntu/IB2TF/Src/Base/Slope_limiter/VanLeer/Slope_limiter.cpp", "C++", 0, 18, 0, 0, 0, 2, 20
"/home/ubuntu/IB2TF/Src/Base/Slope_limiter/minmod/Slope_limiter.cpp", "C++", 0, 18, 0, 0, 0, 3, 21
"/home/ubuntu/IB2TF/Src/BoundaryCondition/BaseGFM/GFM_Bound.cpp", "C++", 0, 106, 0, 0, 40, 8, 154
"/home/ubuntu/IB2TF/Src/BoundaryCondition/BaseGFM/GFM_Method.cpp", "C++", 0, 110, 0, 0, 29, 7, 146
"/home/ubuntu/IB2TF/Src/BoundaryCondition/Regular/RegularBound.cpp", "C++", 0, 52, 0, 0, 13, 5, 70
"/home/ubuntu/IB2TF/Src/BoundaryCondition/SimpleBound/LS_SimpleBound.cpp", "C++", 0, 116, 0, 0, 2, 7, 125
"/home/ubuntu/IB2TF/Src/BoundaryCondition/SimpleBound/Scheme_Index.cpp", "C++", 0, 63, 0, 0, 0, 4, 67
"/home/ubuntu/IB2TF/Src/Geometry/Level_Set.cpp", "C++", 0, 120, 0, 0, 2, 11, 133
"/home/ubuntu/IB2TF/Src/Geometry/Mirror_IDX.cpp", "C++", 0, 29, 0, 0, 1, 3, 33
"/home/ubuntu/IB2TF/Src/Geometry/Psy_coord.cpp", "C++", 0, 26, 0, 0, 0, 2, 28
"/home/ubuntu/IB2TF/Src/Utils/ParamReader.cpp", "C++", 0, 67, 0, 0, 2, 9, 78
"/home/ubuntu/IB2TF/Src/Utils/WriteData.cpp", "C++", 0, 43, 0, 0, 33, 2, 78
"/home/ubuntu/IB2TF/Src/Utils/WriteIDX2TXT.cpp", "C++", 0, 33, 0, 0, 0, 3, 36
"/home/ubuntu/IB2TF/Src/Utils/Write_LS.cpp", "C++", 0, 64, 0, 0, 0, 4, 68
"/home/ubuntu/IB2TF/Test/InclineSod/.VSCodeCounter/2022-03-17_11-05-02/details.md", "Markdown", 21, 0, 0, 0, 0, 6, 27
"/home/ubuntu/IB2TF/Test/InclineSod/.VSCodeCounter/2022-03-17_11-05-02/diff-details.md", "Markdown", 10, 0, 0, 0, 0, 6, 16
"/home/ubuntu/IB2TF/Test/InclineSod/.VSCodeCounter/2022-03-17_11-05-02/diff.md", "Markdown", 14, 0, 0, 0, 0, 7, 21
"/home/ubuntu/IB2TF/Test/InclineSod/.VSCodeCounter/2022-03-17_11-05-02/results.json", "JSON", 0, 0, 0, 1, 0, 0, 1
"/home/ubuntu/IB2TF/Test/InclineSod/.VSCodeCounter/2022-03-17_11-05-02/results.md", "Markdown", 15, 0, 0, 0, 0, 7, 22
"/home/ubuntu/IB2TF/Test/InclineSod/.VSCodeCounter/2022-03-17_11-13-29/details.md", "Markdown", 21, 0, 0, 0, 0, 6, 27
"/home/ubuntu/IB2TF/Test/InclineSod/.VSCodeCounter/2022-03-17_11-13-29/diff-details.md", "Markdown", 11, 0, 0, 0, 0, 6, 17
"/home/ubuntu/IB2TF/Test/InclineSod/.VSCodeCounter/2022-03-17_11-13-29/diff.md", "Markdown", 14, 0, 0, 0, 0, 7, 21
"/home/ubuntu/IB2TF/Test/InclineSod/.VSCodeCounter/2022-03-17_11-13-29/results.json", "JSON", 0, 0, 0, 1, 0, 0, 1
"/home/ubuntu/IB2TF/Test/InclineSod/.VSCodeCounter/2022-03-17_11-13-29/results.md", "Markdown", 15, 0, 0, 0, 0, 7, 22
"/home/ubuntu/IB2TF/Test/InclineSod/.VSCodeCounter/2022-03-17_11-24-25/details.md", "Markdown", 21, 0, 0, 0, 0, 6, 27
"/home/ubuntu/IB2TF/Test/InclineSod/.VSCodeCounter/2022-03-17_11-24-25/diff-details.md", "Markdown", 10, 0, 0, 0, 0, 6, 16
"/home/ubuntu/IB2TF/Test/InclineSod/.VSCodeCounter/2022-03-17_11-24-25/diff.md", "Markdown", 14, 0, 0, 0, 0, 7, 21
"/home/ubuntu/IB2TF/Test/InclineSod/.VSCodeCounter/2022-03-17_11-24-25/results.json", "JSON", 0, 0, 0, 1, 0, 0, 1
"/home/ubuntu/IB2TF/Test/InclineSod/.VSCodeCounter/2022-03-17_11-24-25/results.md", "Markdown", 15, 0, 0, 0, 0, 7, 22
"/home/ubuntu/IB2TF/Test/InclineSod/.VSCodeCounter/2022-03-18_19-33-16/details.md", "Markdown", 15, 0, 0, 0, 0, 6, 21
"/home/ubuntu/IB2TF/Test/InclineSod/.VSCodeCounter/2022-03-18_19-33-16/diff-details.md", "Markdown", 27, 0, 0, 0, 0, 6, 33
"/home/ubuntu/IB2TF/Test/InclineSod/.VSCodeCounter/2022-03-18_19-33-16/diff.md", "Markdown", 21, 0, 0, 0, 0, 7, 28
"/home/ubuntu/IB2TF/Test/InclineSod/.VSCodeCounter/2022-03-18_19-33-16/results.json", "JSON", 0, 0, 0, 1, 0, 0, 1
"/home/ubuntu/IB2TF/Test/InclineSod/.VSCodeCounter/2022-03-18_19-33-16/results.md", "Markdown", 19, 0, 0, 0, 0, 7, 26
"/home/ubuntu/IB2TF/Test/InclineSod/.VSCodeCounter/2022-03-18_19-33-38/details.md", "Markdown", 15, 0, 0, 0, 0, 6, 21
"/home/ubuntu/IB2TF/Test/InclineSod/.VSCodeCounter/2022-03-18_19-33-38/diff-details.md", "Markdown", 9, 0, 0, 0, 0, 6, 15
"/home/ubuntu/IB2TF/Test/InclineSod/.VSCodeCounter/2022-03-18_19-33-38/diff.md", "Markdown", 12, 0, 0, 0, 0, 7, 19
"/home/ubuntu/IB2TF/Test/InclineSod/.VSCodeCounter/2022-03-18_19-33-38/results.json", "JSON", 0, 0, 0, 1, 0, 0, 1
"/home/ubuntu/IB2TF/Test/InclineSod/.VSCodeCounter/2022-03-18_19-33-38/results.md", "Markdown", 19, 0, 0, 0, 0, 7, 26
"/home/ubuntu/IB2TF/Test/InclineSod/InclineSod.cpp", "C++", 0, 103, 0, 0, 4, 19, 126
"/home/ubuntu/IB2TF/Test/InclineSod/Initialize.cpp", "C++", 0, 62, 0, 0, 0, 0, 62
"/home/ubuntu/IB2TF/Test/InclineSod/Level_Set_function.cpp", "C++", 0, 25, 0, 0, 1, 3, 29
"/home/ubuntu/IB2TF/Test/InclineSod/Makefile", "Makefile", 0, 0, 32, 0, 0, 12, 44
"/home/ubuntu/IB2TF/Test/Sod/.VSCodeCounter/2022-03-17_11-05-02/details.md", "Markdown", 21, 0, 0, 0, 0, 6, 27
"/home/ubuntu/IB2TF/Test/Sod/.VSCodeCounter/2022-03-17_11-05-02/diff-details.md", "Markdown", 10, 0, 0, 0, 0, 6, 16
"/home/ubuntu/IB2TF/Test/Sod/.VSCodeCounter/2022-03-17_11-05-02/diff.md", "Markdown", 14, 0, 0, 0, 0, 7, 21
"/home/ubuntu/IB2TF/Test/Sod/.VSCodeCounter/2022-03-17_11-05-02/results.json", "JSON", 0, 0, 0, 1, 0, 0, 1
"/home/ubuntu/IB2TF/Test/Sod/.VSCodeCounter/2022-03-17_11-05-02/results.md", "Markdown", 15, 0, 0, 0, 0, 7, 22
"/home/ubuntu/IB2TF/Test/Sod/.VSCodeCounter/2022-03-17_11-13-29/details.md", "Markdown", 21, 0, 0, 0, 0, 6, 27
"/home/ubuntu/IB2TF/Test/Sod/.VSCodeCounter/2022-03-17_11-13-29/diff-details.md", "Markdown", 11, 0, 0, 0, 0, 6, 17
"/home/ubuntu/IB2TF/Test/Sod/.VSCodeCounter/2022-03-17_11-13-29/diff.md", "Markdown", 14, 0, 0, 0, 0, 7, 21
"/home/ubuntu/IB2TF/Test/Sod/.VSCodeCounter/2022-03-17_11-13-29/results.json", "JSON", 0, 0, 0, 1, 0, 0, 1
"/home/ubuntu/IB2TF/Test/Sod/.VSCodeCounter/2022-03-17_11-13-29/results.md", "Markdown", 15, 0, 0, 0, 0, 7, 22
"/home/ubuntu/IB2TF/Test/Sod/.VSCodeCounter/2022-03-17_11-24-25/details.md", "Markdown", 21, 0, 0, 0, 0, 6, 27
"/home/ubuntu/IB2TF/Test/Sod/.VSCodeCounter/2022-03-17_11-24-25/diff-details.md", "Markdown", 10, 0, 0, 0, 0, 6, 16
"/home/ubuntu/IB2TF/Test/Sod/.VSCodeCounter/2022-03-17_11-24-25/diff.md", "Markdown", 14, 0, 0, 0, 0, 7, 21
"/home/ubuntu/IB2TF/Test/Sod/.VSCodeCounter/2022-03-17_11-24-25/results.json", "JSON", 0, 0, 0, 1, 0, 0, 1
"/home/ubuntu/IB2TF/Test/Sod/.VSCodeCounter/2022-03-17_11-24-25/results.md", "Markdown", 15, 0, 0, 0, 0, 7, 22
"/home/ubuntu/IB2TF/Test/Sod/.VSCodeCounter/2022-03-18_19-33-16/details.md", "Markdown", 15, 0, 0, 0, 0, 6, 21
"/home/ubuntu/IB2TF/Test/Sod/.VSCodeCounter/2022-03-18_19-33-16/diff-details.md", "Markdown", 27, 0, 0, 0, 0, 6, 33
"/home/ubuntu/IB2TF/Test/Sod/.VSCodeCounter/2022-03-18_19-33-16/diff.md", "Markdown", 21, 0, 0, 0, 0, 7, 28
"/home/ubuntu/IB2TF/Test/Sod/.VSCodeCounter/2022-03-18_19-33-16/results.json", "JSON", 0, 0, 0, 1, 0, 0, 1
"/home/ubuntu/IB2TF/Test/Sod/.VSCodeCounter/2022-03-18_19-33-16/results.md", "Markdown", 19, 0, 0, 0, 0, 7, 26
"/home/ubuntu/IB2TF/Test/Sod/.VSCodeCounter/2022-03-18_19-33-38/details.md", "Markdown", 15, 0, 0, 0, 0, 6, 21
"/home/ubuntu/IB2TF/Test/Sod/.VSCodeCounter/2022-03-18_19-33-38/diff-details.md", "Markdown", 9, 0, 0, 0, 0, 6, 15
"/home/ubuntu/IB2TF/Test/Sod/.VSCodeCounter/2022-03-18_19-33-38/diff.md", "Markdown", 12, 0, 0, 0, 0, 7, 19
"/home/ubuntu/IB2TF/Test/Sod/.VSCodeCounter/2022-03-18_19-33-38/results.json", "JSON", 0, 0, 0, 1, 0, 0, 1
"/home/ubuntu/IB2TF/Test/Sod/.VSCodeCounter/2022-03-18_19-33-38/results.md", "Markdown", 19, 0, 0, 0, 0, 7, 26
"/home/ubuntu/IB2TF/Test/Sod/Initialize.cpp", "C++", 0, 51, 0, 0, 2, 0, 53
"/home/ubuntu/IB2TF/Test/Sod/Level_Set_function.cpp", "C++", 0, 9, 0, 0, 0, 4, 13
"/home/ubuntu/IB2TF/Test/Sod/Makefile", "Makefile", 0, 0, 32, 0, 0, 13, 45
"/home/ubuntu/IB2TF/Test/Sod/Sod.cpp", "C++", 0, 99, 0, 0, 1, 18, 118
"Total", "-", 638, 1859, 64, 10, 139, 439, 3149