"filename", "language", "C++", "Makefile", "comment", "blank", "total"
"/home/ubuntu/IB2TF/Src/Base/Advance/Lax/Lax_Scheme.cpp", "C++", 68, 0, 9, 6, 83
"/home/ubuntu/IB2TF/Src/Base/Advance/MUSCL/MUSCL_Scheme.cpp", "C++", 112, 0, 0, 7, 119
"/home/ubuntu/IB2TF/Src/Base/Common/ComputeDt.cpp", "C++", 37, 0, 0, 3, 40
"/home/ubuntu/IB2TF/Src/Base/Common/Conserve2Flux.cpp", "C++", 32, 0, 0, 4, 36
"/home/ubuntu/IB2TF/Src/Base/ComputeDt.cpp", "C++", -37, 0, 0, -3, -40
"/home/ubuntu/IB2TF/Src/Base/Conserve2Flux.cpp", "C++", -32, 0, 0, -4, -36
"/home/ubuntu/IB2TF/Src/Base/Lax_Scheme.cpp", "C++", -60, 0, -9, -6, -75
"/home/ubuntu/IB2TF/Src/Base/MUSCL_Scheme.cpp", "C++", -112, 0, 0, -7, -119
"/home/ubuntu/IB2TF/Src/Base/Riemann/HLL/Riemann_solver.cpp", "C++", 99, 0, 0, 7, 106
"/home/ubuntu/IB2TF/Src/Base/Riemann_solver.cpp", "C++", -99, 0, 0, -7, -106
"/home/ubuntu/IB2TF/Src/Base/Slope_limiter.cpp", "C++", -15, 0, 0, 0, -15
"/home/ubuntu/IB2TF/Src/Base/Slope_limiter/minmod/Slope_limiter.cpp", "C++", 15, 0, 0, 0, 15
"/home/ubuntu/IB2TF/Src/BoundaryCondition/BaseGFM/GFM_Bound.cpp", "C++", 106, 0, 40, 8, 154
"/home/ubuntu/IB2TF/Src/BoundaryCondition/BaseGFM/GFM_Method.cpp", "C++", 110, 0, 29, 7, 146
"/home/ubuntu/IB2TF/Src/BoundaryCondition/GFM_Bound.cpp", "C++", -93, 0, -40, -7, -140
"/home/ubuntu/IB2TF/Src/BoundaryCondition/LS_SimpleBound.cpp", "C++", -110, 0, -2, -8, -120
"/home/ubuntu/IB2TF/Src/BoundaryCondition/Regular/RegularBound.cpp", "C++", 52, 0, 13, 5, 70
"/home/ubuntu/IB2TF/Src/BoundaryCondition/RegularBound.cpp", "C++", -49, 0, -13, -5, -67
"/home/ubuntu/IB2TF/Src/BoundaryCondition/SimpleBound/LS_SimpleBound.cpp", "C++", 116, 0, 2, 7, 125
"/home/ubuntu/IB2TF/Src/BoundaryCondition/SimpleBound/Scheme_Index.cpp", "C++", 63, 0, 0, 4, 67
"/home/ubuntu/IB2TF/Src/Geometry/GFM_Method.cpp", "C++", -110, 0, -29, -7, -146
"/home/ubuntu/IB2TF/Src/Geometry/Level_Set.cpp", "C++", 10, 0, 0, 2, 12
"/home/ubuntu/IB2TF/Src/Geometry/Scheme_Index.cpp", "C++", -63, 0, 0, -4, -67
"/home/ubuntu/IB2TF/Src/Utils/WriteData.cpp", "C++", -31, 0, 33, -2, 0
"/home/ubuntu/IB2TF/Test/InclineSod/InclineSod.cpp", "C++", -3, 0, -3, 0, -6
"/home/ubuntu/IB2TF/Test/InclineSod/Makefile", "Makefile", 0, 20, 0, 7, 27
"/home/ubuntu/IB2TF/Test/Sod/Makefile", "Makefile", 0, 19, 0, 9, 28
"/home/ubuntu/IB2TF/Test/Sod/Sod.cpp", "C++", 0, 0, -2, 0, -2
"Total", "-", 6, 39, 28, 16, 89